NO ./textures/greystone.xpm
SO ./textures/eagle.xpm
EA ./textures/bluestone.xpm
WE ./textures/colorstone.xpm


F 0,53,100
C 51,185,200


11111111111
10E00000001
10000000001
11111111111