C 255,20 ,30
NO ./textures/brain_coral.xpm
SO ./textures/horn_coral.xpm
EA ./textures/purplestone.xpm
WE ./textures/red_mushroom.xpm

F  128, 65, 32

111111111111111111111111111111                11
111111111000000000000000011111                101
     100000000111111100011                    11
111111100000001  1000000001111                11
100001111111001  1000000111111
1111111000000N1111000000000001
111111111111111111111011111111111
                    111

11111111111111111111111111111

1111111111111111111111111111111
111100000000001100000000000011
110000000000011110000000000011
100000000000111000000000000001
110000000000111000000000001111
110000000001111000000000000111
111111111111111111111111111111111