C 255,20 ,30
NO      ./textures/brain_coral.xpm
SO ./textures/horn_coral.xpm
EA ./textures/purplestone.xpm
WE ./textures/red_mushroom.xpm

F  128, 65, 32

111111111111111111111111111111
111111111000200000000000011111
     1000000001111111000100001
111111100000001  1000000001111
100001111111001  1020000111111
111111100000001111000000000001
111100000000001100000002000011
110000000000011110000000000011
100000000000111000W00000000011
110000000000111000000000001111
110000000001111000000000000111
111111111111111111111111111111111
