
NO ./textures/greystone.xpm
SO ./textures/eagle.xpm
EA ./textures/bluestone.xpm
WE ./textures/colorstonee.xpm



C 51,185,200
F 0,53,00

11111111111
10E00000001
10000000001
11111111111