NO ./textures/greystone.xpm
SO ./textures/eagle.xpm
EA ./textures/bluestone.xpm
WE ./textures/colorstone.xpm


F 255,0,0
         C         0   ,     00000    ,     255    


11111111111
10E00000001
10000000001
11111111111